## Generated File - Do not modify
# ████████████████████
# ██░░░░░░░░░░░░░░░░██
# ██░░████░░░░████░░██
# ██░░████░░░░████░░██
# ██░░░░░░████░░░░░░██
# ██░░░░░░████░░░░░░██
# ██░░░░████████░░░░██
# ██░░░░██░░░░██░░░░██
# ██░░░░░░░░░░░░░░░░██
# ████████████████████
########################
# REMOVE WAYPOINT TAGS #
########################
tag @a remove wp__active
