## Generated File - Do not modify
# ████████████████████
# ██░░░░░░░░░░░░░░░░██
# ██░░████░░░░████░░██
# ██░░████░░░░████░░██
# ██░░░░░░████░░░░░░██
# ██░░░░░░████░░░░░░██
# ██░░░░████████░░░░██
# ██░░░░██░░░░██░░░░██
# ██░░░░░░░░░░░░░░░░██
# ████████████████████
##################
# TICK WAYPOINTS #
##################
testfor @s
